111111111111
1P0000000001
1010000100E1
1C10000C1101
11111111111