111111111111
1P0000000001
100000010001
1E10000C1001
111111111111