111111111111
1P0000010001
100000011001
1E10000C0001
111111111111