111111111111
1P0000000001
100000000001
1E10000C0001
111111111111