111111111111
1P0000000001
101000010001 
1C10000C1001
111111111111