111111111111
1P0000010001
100000011001
1EC0000C0001
111111111111